32

grid
########
####G.##
####.L.#
#.K#RRR#
#UR.UR.#
#.#U..H#
#.##.###
#....###
########

spikes
........
........
........
........
........
........
.S..s...
.sSsS...
........

objectives
........
.....O..
....O...
........
........
........
........
........
........
