23

grid
########
####.G##
###.LC.#
#H#..R.#
#.#....#
#U#RRRR#
#......#
######K#
########

spikes
........
........
........
...s....
....s.s.
........
.s.s..s.
........
........

objectives
........
....O...
.....O..
........
........
........
........
........
........
