23

grid
##########
#H#K.R####
#.R.R.L.##
#R.R.RR.G#
#.R.R.RC.#
##.R.R.###
##########

spikes
..........
..........
...TT.....
..........
..........
..........
..........

objectives
..........
..........
..........
.......O..
........O.
..........
..........
