43

grid
#########
##.H.####
##RRR####
#...K####
##.R..###
##U#RR..#
##..R.U##
#####LC.#
#####.G##
#########

spikes
.........
.........
.........
.........
..ss.....
.........
.........
.........
.........
.........

objectives
.........
.........
.........
.........
.........
.........
.........
......O..
.....O...
.........
