32

grid
##########
####GGG.##
#######L##
###.....H#
###.#.#..#
###..U..##
#K#.#.#.##
#.....U.##
##########

spikes
..........
..........
..........
....TT....
...T.T....
......TT..
...T.T....
..........
..........

objectives
..........
.......O..
..........
..........
..........
..........
..........
..........
..........
