24

grid
#########
##....###
##U#....#
#..##RRR#
#..##...#
#H.##.U.#
#####G.U#
#########

spikes
.........
.........
....TT...
..T..TT..
......T..
.........
.........
.........

objectives
.........
.........
.........
.........
.........
.....O...
......O..
.........
