23

grid
#########
#####.H##
##..U..##
##.U.U###
#..######
#.R..R.##
#.R.R..G#
#########

spikes
.........
.........
.........
.........
.........
.........
.........
.........

objectives
.........
.........
.........
.........
.........
.........
......O..
.........
