33

grid
###########
####...####
####RLR####
##R#R..#.##
#R..RRR..K#
#.RRR..RR.#
##H.R..R.##
###########

spikes
...........
...........
...........
...........
...........
...........
...........
...........

objectives
...........
....OOO....
...........
...........
...........
...........
...........
...........
